{
  "data" :[
    [0,0,0,0,0,0,0,0,0,0,0,0,0],
    [1,1,1,0,0,0,0,0,0,0,0,0,-2],
    [1,1,1,0,0,0,0,0,0,0,0,0,-2],
    [0,0,0,0,0,0,0,0,0,0,0,0,0],
    [1,1,1,0,0,1,1,1,0,0,1,1,1],
    [1,1,1,0,0,1,1,1,0,0,1,1,1],
    [0,0,0,0,0,0,0,0,0,0,0,0,0],
    [1,1,1,0,0,1,1,1,0,0,1,1,1],
    [1,1,1,0,0,1,1,1,0,0,1,1,1],
    [0,0,0,0,0,0,0,0,0,0,0,0,0],
    [1,1,1,0,0,1,1,1,0,0,1,1,1],
    [1,1,1,0,0,1,1,1,0,0,1,1,1],
    [0,0,0,0,0,0,0,0,0,0,0,0,0]
  ],
  "spawnTabX" : 1,
  "spawnTabY" : 12,
  "spawnX" : 97,
  "spawnY" : 485,
  "xMax" : 13,
  "yMax" : 13,
  "tailleFondX" : 600,
  "tailleFondY" : 600,
  "tailleDeplacement" : 35,
  "leviers" : [
    {
      "xTab" : 2,
      "yTab" : 12,
      "x" : 490,
      "y" : 57,
      "action" : "tabNiveau.tab[12][1] = -1;\ntabNiveau.tab[12][2] = -1;\nalert('porte ouverte');\n"
    }
  ]
}
