{
  "data" :[
    [0,0,0,0,0,0,0,0,0,0,0,0,0],
    [1,1,1,0,0,0,0,0,0,0,0,0,-1],
    [1,1,1,0,0,0,0,0,0,0,0,0,-1],
    [0,0,0,0,0,0,0,0,0,0,0,0,0],
    [1,1,1,0,0,1,1,1,0,0,1,1,1],
    [1,1,1,0,0,1,1,1,0,0,1,1,1],
    [0,0,0,0,0,0,0,0,0,0,0,0,0],
    [1,1,1,0,0,1,1,1,0,0,1,1,1],
    [1,1,1,0,0,1,1,1,0,0,1,1,1],
    [0,0,0,0,0,0,0,0,0,0,0,0,0],
    [1,1,1,0,0,1,1,1,0,0,1,1,1],
    [1,1,1,0,0,1,1,1,0,0,1,1,1],
    [0,0,0,0,0,0,0,0,0,0,0,0,0]
  ],
  "spawnTabX" : 1,
  "spawnTabY" : 12,
  "spawnX" : 97,
  "spawnY" : 485,
  "xMax" : 13,
  "yMax" : 3,
  "tailleFondX" : 600,
  "tailleFondY" : 600,
  "tailleDeplacement" : 35
}
