{
  "data" :
    [
      [1,1,1,1,1,1,1,0,0,0,0,0,0,0,0],
      [1,1,1,1,1,1,1,0,0,0,0,0,0,0,0],
      [1,1,1,1,1,1,1,1,1,1,1,0,0,1,1],
      [1,1,1,1,1,1,1,1,1,1,1,0,0,1,1],
      [0,0,0,0,0,0,0,0,0,0,0,0,0,0,0],
      [0,1,1,1,0,0,0,0,0,0,0,0,0,0,0],
      [0,1,1,1,0,0,0,0,0,0,0,0,0,0,0],
      [0,0,0,0,0,0,0,0,0,0,0,0,0,0,0],
      [0,1,1,1,0,0,0,0,0,0,0,0,0,0,0],
      [0,1,1,1,0,0,0,0,0,0,0,0,0,0,0],
      [0,0,0,0,0,0,0,1,1,1,1,1,1,1,1],
      [0,1,1,1,0,0,0,1,1,1,1,1,1,1,1],
      [0,1,1,1,0,0,0,0,0,0,0,0,0,0,0],
      [0,0,0,0,0,0,0,0,0,0,0,0,0,0,0],
      [0,0,0,0,0,0,0,0,0,0,0,0,-2,0,0]
  ],
  "data-real" :[
    [1,1,1,1,1,1,1,0,0,0,0,0,0,0,0],
    [1,1,1,1,1,1,1,0,0,0,0,0,0,0,0],
    [1,1,1,1,1,1,1,1,1,1,1,0,0,1,1],
    [1,1,1,1,1,1,1,1,1,1,1,0,0,1,1],
    [0,0,0,0,0,0,0,0,0,0,0,0,0,0,0],
    [0,1,1,1,0,0,0,0,0,0,0,0,0,0,0],
    [0,1,1,1,0,0,0,0,0,0,0,0,0,0,0],
    [0,0,0,0,0,0,0,0,0,0,0,0,0,0,0],
    [0,1,1,1,0,0,0,0,0,0,0,0,0,0,0],
    [0,1,1,1,0,0,0,0,0,0,0,0,0,0,0],
    [0,0,0,0,0,0,0,1,1,1,1,1,1,1,1],
    [0,1,1,1,0,0,0,1,1,1,1,1,1,1,1],
    [0,1,1,1,0,0,0,0,0,0,0,0,0,0,0],
    [0,0,0,0,0,0,0,0,0,0,0,0,0,0,0],
    [0,0,0,0,0,0,0,0,0,0,0,0,-2,0,0]
  ],
  "spawnTabX" : 12,
  "spawnTabY" : 14,
  "spawnX" : 441,
  "spawnY" : 505,
  "tailleXHeros" : 40,
  "tailleYHeros" : 40,
  "xMax" : 14,
  "yMax" : 14,
  "tailleFondX" : 600,
  "tailleFondY" : 600,
  "tailleDeplacement" : 32.1,
  "porte" : {
    "xTab" : 12,
    "yTab" : 14,
    "x" : 385,
    "y" : 538,
    "tailleX" : 144,
    "tailleY" : 50,
    "imgFermee" : "porte-fermee-bas.png",
    "imgOuverte" : "porte-ouverte-bas.png"
  },
  "ramassables" : [
    {
      "xTab" : 6,
      "yTab" : 1,
      "x" : 233,
      "y" : 65,
      "tailleX" : 40,
      "tailleY" : 40,
      "img" : "carnet.png",
      "action" : "porte.ouvre();\nporte.x+= 8;\n"
    }
  ],
  "alertesDebut" : [
    "pour réussir ce niveau tu dois ramasser ton carnet de liaison et t échapper",
    "attention au surveillant, il ne doit pas pouvoir te voir quand tu es dans la zone rouge"
  ]
}
